..........
.......#..
..#..#....
..#....##.
#.#.......
#.#.......
..........
..#.###..#
..........
##...###..
