..#.......
.....#.###
.....#....
.....#....
###..#....
........##
.#........
....#.....
#.........
#.##..#...
